                                               
          ############                         
          #..........#                         
          #..........#                         
          #..........#                         
          #..........#        ########         
  #########..........#        #......#         
  #..................#        #......#         
  ##X######..........##########......#         
          #..........................#         
          ########.#.##########......#         
   ###############.#.##       #......#         
   #.........##.......#       #......#         
   #.........##.......#       ##.#####         
   #.........##.......#      ###.#######       
   #.........##.......########.........#       
   #...................................#       
   #...................................#       
   ####.##########.###########.........#       
      #.#        #.#    #..............#       
      #.#        #.#    #.####.........#       
      #.#        #.#    #.#  ###.#######       
      #.#        #.#    #.#    #.#             
      #.#        #.#    #.#    #.#             
      #.#        #.#    #.#    #.#             
   ####.####     #.#    #.#    #.#             
   #.......#######.#    #.#    #.#             
   #...............######.######.#             
   #...S.........................#             
   #.......##############.########             
   #.......#            ###                    
   ####X####                                   
                                                           
                                                 
