                          ############            
                          #..........#            
                          #..........#            
                          #..........#            
                    #######..........#            
                    #................#            
                    #.#####..........#            
                    #.#   ##########.#            
                    #.#     #........#            
                    #.#     #........#            
             ########.###   #........#            
             #..........#   #........#            
             #..........#   #........#            
             #..........#   #........#            
   ###########..........#####........#            
   #.........#.......................#            
   #.................................#        ### 
   #.........#.......................#        #.# 
   #.........#..........##############        #.# 
   #.........#..........#######################.##
   #.............................................#
   ########################################......#
                                          #......#
                                          #......#
                                          #......#
                                          #......#
                                          #......#
                                          #......#
                                          ########
                                                  
 
